................
....&...........
..........E.....
&&..&...........
....&&&.........
......&&&&..&&..
................
.......&........
.....&.&........
....S...........
.......&.&&.....
.......&.&&.....
